99,99,99,99,99,99,99,99,99,99,99,99,99,99,99,99,99,99,99,99,99,99,99,99,99,99,99,99,99,99,99,99,99,99,99,99,99,99,99,99
00,01,01,01,01,01,01,01,05,99,30,01,01,01,01,01,01,01,01,01,01,01,01,01,01,01,01,01,01,01,01,01,01,01,01,01,01,01,35,99
10,23,23,23,23,23,23,23,15,99,30,23,23,23,23,23,23,23,23,23,23,23,23,23,23,23,23,23,23,23,23,23,23,23,23,23,23,23,35,99
10,23,23,23,23,23,23,23,15,99,30,23,23,23,23,23,23,23,23,23,23,23,23,23,23,23,23,23,23,23,23,23,23,23,23,23,23,23,35,99
10,23,23,23,23,23,23,23,15,99,30,23,23,23,23,23,23,23,23,23,23,23,23,23,23,23,23,23,23,23,23,23,23,23,23,23,23,23,35,99
10,23,23,23,23,23,23,23,15,99,30,23,23,23,23,23,23,23,23,23,23,23,23,23,23,23,23,23,23,23,23,23,23,23,23,23,23,23,35,99
10,23,23,23,23,23,23,23,15,99,30,23,23,23,23,23,23,23,23,23,23,23,23,23,23,23,23,23,50,53,23,23,23,23,23,23,23,23,35,99
10,23,23,23,23,23,23,23,15,99,30,23,23,23,23,23,23,23,23,23,23,23,23,23,23,23,23,23,15,10,23,23,23,23,23,23,23,23,35,99
40,41,53,23,23,23,54,41,45,99,30,23,23,23,23,23,23,23,23,23,23,23,23,23,23,23,23,23,15,10,23,23,23,23,23,23,23,23,35,99
99,99,10,23,23,23,15,99,99,99,30,23,23,23,23,23,23,23,23,23,23,23,23,23,23,23,23,23,15,10,23,23,23,23,23,23,23,23,35,99
99,99,10,23,23,23,15,99,99,99,30,23,23,23,23,23,23,23,23,23,23,23,23,23,23,23,23,23,15,10,23,23,23,23,23,23,23,23,35,99
99,99,10,23,23,23,15,99,99,99,40,41,41,41,41,41,41,41,41,53,50,41,41,41,41,41,41,41,42,42,41,41,41,23,23,23,23,23,35,99
99,99,10,23,23,23,15,99,99,99,99,99,99,99,99,99,99,99,50,42,53,23,23,23,23,23,23,23,23,23,23,23,23,23,23,23,23,23,35,99
00,41,42,23,23,23,43,44,44,44,44,44,44,44,44,44,44,44,05,99,00,23,23,23,23,23,23,23,23,23,23,23,23,23,23,23,23,23,35,99
10,23,23,23,23,23,23,23,23,23,23,23,23,23,23,23,23,23,15,99,00,23,23,23,23,23,23,23,23,23,23,23,23,23,23,23,23,23,35,99
10,23,23,23,23,23,23,23,23,23,23,23,23,23,23,23,23,23,15,99,00,23,23,23,23,23,23,23,23,23,23,23,23,23,23,23,23,23,35,99
10,23,23,23,23,23,23,23,23,23,23,23,23,23,23,23,23,23,15,99,00,23,23,23,23,23,23,23,23,23,23,23,23,23,23,23,23,23,35,99
10,23,23,23,23,23,23,23,23,23,23,23,23,23,23,23,23,23,15,99,00,23,23,23,23,23,23,23,23,23,23,23,23,23,23,23,23,23,35,99
10,23,23,23,23,23,23,23,23,23,23,23,23,23,23,23,23,23,15,99,00,23,23,23,23,23,23,23,23,23,23,23,23,23,23,23,23,23,35,99
10,23,23,23,23,23,23,23,23,23,23,23,23,23,23,23,23,23,15,99,00,23,23,23,23,23,23,23,23,23,23,23,23,23,23,23,23,23,35,99
10,23,23,23,23,23,23,23,23,23,23,23,23,23,23,23,23,23,15,99,00,23,23,23,23,23,23,23,23,23,23,23,23,23,23,23,23,23,35,99
10,23,23,23,23,23,23,23,23,23,23,23,23,23,23,23,23,23,15,99,00,23,23,23,23,23,23,23,23,23,23,23,23,23,23,23,23,23,35,99
10,23,23,23,23,23,23,23,23,23,23,23,23,23,23,23,23,23,15,99,00,23,23,23,23,23,23,23,23,23,23,23,23,23,23,23,23,23,35,99
10,23,23,23,23,23,23,23,23,23,23,23,23,23,23,23,23,23,42,42,42,23,23,23,23,23,23,23,23,23,23,23,23,23,23,23,23,23,35,99
10,23,23,23,23,23,23,23,23,23,23,23,23,23,23,23,23,23,23,23,23,23,23,23,23,23,23,23,23,23,23,23,23,23,23,23,23,23,35,99
10,23,23,23,23,23,23,23,23,23,23,23,23,23,23,23,23,23,23,23,23,23,23,23,23,23,23,23,23,23,23,23,23,23,23,23,23,23,35,99
10,23,23,23,23,23,23,23,23,23,23,23,23,23,23,23,23,23,23,23,23,23,23,23,23,23,23,23,23,23,23,23,23,23,23,23,23,23,35,99
10,23,23,23,23,23,23,23,23,23,23,23,23,23,23,23,23,23,23,23,23,23,23,23,23,23,23,23,23,23,23,23,23,23,23,23,23,23,35,99
40,41,41,41,41,41,41,41,41,41,41,41,41,41,41,41,41,41,44,44,44,44,44,44,44,44,44,44,44,44,44,44,44,44,44,44,44,44,45,99
99,99,99,99,99,99,99,99,99,99,99,99,99,99,99,99,99,99,99,99,99,99,99,99,99,99,99,99,99,99,99,99,99,99,99,99,99,99,99,99

0,0,0,0,0,0,0,0,0,0,0,0,0,0,0,0,0,0,0,0,0,0,0,0,0,0,0,0,0,0,0,0,0,0,0,0,0,0,0,0
1,1,1,1,1,1,1,1,1,0,1,1,1,1,1,1,1,1,1,1,1,1,1,1,1,1,1,1,1,1,1,1,1,1,1,1,1,1,1,0
1,0,0,0,0,0,0,0,1,0,1,0,0,0,0,0,0,0,0,0,0,0,0,0,0,0,0,0,0,0,0,0,0,0,0,0,0,0,1,0
1,0,0,0,0,0,0,0,1,0,1,0,0,0,0,0,0,0,0,0,0,0,0,0,0,0,0,0,0,0,0,0,0,0,0,0,0,0,1,0
1,0,0,0,0,0,0,0,1,0,1,0,0,0,0,0,0,0,0,0,0,0,0,0,0,0,0,0,0,0,0,0,0,0,0,0,0,0,1,0
1,0,0,0,0,0,0,0,1,0,1,0,0,0,0,0,0,0,0,0,0,0,0,0,0,0,0,0,0,0,0,0,0,0,0,0,0,0,1,0
1,0,0,0,0,0,0,0,1,0,1,0,0,0,0,0,0,0,0,0,0,0,0,0,0,0,0,0,1,1,0,0,0,0,0,0,0,0,1,0
1,0,0,0,0,0,0,0,1,0,1,0,0,0,0,0,0,0,0,0,0,0,0,0,0,0,0,0,1,1,0,0,0,0,0,0,0,0,1,0
1,1,1,0,0,0,1,1,1,0,1,0,0,0,0,0,0,0,0,0,0,0,0,0,0,0,0,0,1,1,0,0,0,0,0,0,0,0,1,0
0,0,1,0,0,0,1,0,0,0,1,0,0,0,0,0,0,0,0,0,0,0,0,0,0,0,0,0,1,1,0,0,0,0,0,0,0,0,1,0
0,0,1,0,0,0,1,0,0,0,1,0,0,0,0,0,0,0,0,0,0,0,0,0,0,0,0,0,1,1,0,0,0,0,0,0,0,0,1,0
0,0,1,0,0,0,1,0,0,0,1,1,1,1,1,1,1,1,1,1,1,1,1,1,1,1,1,1,1,1,1,1,1,0,0,0,0,0,1,0
0,0,1,0,0,0,1,0,0,0,0,0,0,0,0,0,0,0,1,1,1,0,0,0,0,0,0,0,0,0,0,0,0,0,0,0,0,0,1,0
1,1,1,0,0,0,1,1,1,1,1,1,1,1,1,1,1,1,1,0,1,0,0,0,0,0,0,0,0,0,0,0,0,0,0,0,0,0,1,0
1,0,0,0,0,0,0,0,0,0,0,0,0,0,0,0,0,0,1,0,1,0,0,0,0,0,0,0,0,0,0,0,0,0,0,0,0,0,1,0
1,0,0,0,0,0,0,0,0,0,0,0,0,0,0,0,0,0,1,0,1,0,0,0,0,0,0,0,0,0,0,0,0,0,0,0,0,0,1,0
1,0,0,0,0,0,0,0,0,0,0,0,0,0,0,0,0,0,1,0,1,0,0,0,0,0,0,0,0,0,0,0,0,0,0,0,0,0,1,0
1,0,0,0,0,0,0,0,0,0,0,0,0,0,0,0,0,0,1,0,1,0,0,0,0,0,0,0,0,0,0,0,0,0,0,0,0,0,1,0
1,0,0,0,0,0,0,0,0,0,0,0,0,0,0,0,0,0,1,0,1,0,0,0,0,0,0,0,0,0,0,0,0,0,0,0,0,0,1,1
1,0,0,0,0,0,0,0,0,0,0,0,0,0,0,0,0,0,1,0,1,0,0,0,0,0,0,0,0,0,0,0,0,0,0,0,0,0,1,1
1,0,0,0,0,0,0,0,0,0,0,0,0,0,0,0,0,0,1,0,1,0,0,0,0,0,0,0,0,0,0,0,0,0,0,0,0,0,1,1
1,0,0,0,0,0,0,0,0,0,0,0,0,0,0,0,0,0,1,0,1,0,0,0,0,0,0,0,0,0,0,0,0,0,0,0,0,0,1,0
1,0,0,0,0,0,0,0,0,0,0,0,0,0,0,0,0,0,1,0,1,0,0,0,0,0,0,0,0,0,0,0,0,0,0,0,0,0,1,1
1,0,0,0,0,0,0,0,0,0,0,0,0,0,0,0,0,0,1,1,1,0,0,0,0,0,0,0,0,0,0,0,0,0,0,0,0,0,1,1
1,0,0,0,0,0,0,0,0,0,0,0,0,0,0,0,0,0,0,0,0,0,0,0,0,0,0,0,0,0,0,0,0,0,0,0,0,0,1,1
1,0,0,0,0,0,0,0,0,0,0,0,0,0,0,0,0,0,0,0,0,0,0,0,0,0,0,0,0,0,0,0,0,0,0,0,0,0,1,1
1,0,0,0,0,0,0,0,0,0,0,0,0,0,0,0,0,0,0,0,0,0,0,0,0,0,0,0,0,0,0,0,0,0,0,0,0,0,1,0
1,0,0,0,0,0,0,0,0,0,0,0,0,0,0,0,0,0,0,0,0,0,0,0,0,0,0,0,0,0,0,0,0,0,0,0,0,0,1,0
1,1,1,1,1,1,1,1,1,1,1,1,1,1,1,1,1,1,1,1,1,1,1,1,1,1,1,1,1,1,1,1,1,1,1,1,1,1,1,0
0,0,0,0,0,0,0,0,0,0,0,0,0,0,0,0,0,0,0,0,0,0,0,0,0,0,0,0,0,0,0,0,0,0,0,0,0,0,0,0
